#===========================================#
#.....................p.....................#
#...........................................#
#...........................................#
#...........................................#
#...........................................#
#...........................................#
#...........................................#
#...........................................#
#...........................................#
#...........................................#
#...........................................#
#...........................................#
#...........................................#
#...........................................#
#...........................................#
#...........................................#
#...........................................#
#...........................................#
#...........................................#
#...........................................#
#...........................................#
#...........................................#
#...........................................#
#...........................................#
#...........................................#
#...........................................#
#...........................................#
#...........................................#
#...........................................#
#===========================================#
#...........................................#
#...........................................#
#...........................................#
#...........................................#
#...........................................#