#===========================================#
#...........................................#
#...........................................#
#...........................................#
#...........................................#
#..............................<=====>......#
#.................................p.........#
#...........................................#
#...........................................#
#...........................................#
#...........................................#
#...........................................#
#...........................................#
#...........................................#
#...........................................#
#...........................................#
#...........................................#
#...........................................#
#...........................................#
#...........................................#
#...........................................#
#...........................................#
#...........................................#
#...........................................#
#...........................................#
#...........................................#
#...........................................#
#...........................................#
#...........................................#
#...........................................#
#===========================================#
#...........................................#
#...........................................#
#...........................................#
#...........................................#
#...........................................#