#======================================#
#......................................#
#......................................#
#......................................#
#......................................#
#..............==========..............#
#......................................#
#......................................#
#......................................#
#.............................=========#
#......................................#
#......................................#
#......................................#
#......................................#
#.........==========...................#
#......................................#
#......................................#
#......................................#
#......................................#
#...........................===========#
#......................................#
#......................................#
#......................................#
#......................................#
#======================================#