#===========================================#
#.p........................2................#
#...........................................#
#...........................................#
#...........................................#
#===================================>.......#
#..........3................................#
#...........................................#
#...........................................#
#...........................................#
#.......<===================================#
#........................................2..#
#...........................................#
#...........................................#
#...........................................#
#===========>...............................#
#..2........................................#
#...........................................#
#...........................................#
#...........................................#
#...............<===========>...............#
#...................3.......................#
#...........................................#
#...........................................#
#.....4.....................................#
#...............................<===========#
#.................................2......A..#
#...........................................#
#...........................................#
#...........................................#
#===========================================#
#...........................................#
#...........................................#
#...........................................#
#...........................................#
#...........................................#