#======================================#
#.............==......==...............#
#......................................#
#......................................#
#......................................#
#========...................===========#
#===...................................#
#=.....................................#
#......................................#
#......................................#
#......................................#
#......................................#
#......................................#
#......................................#
#.........==========...................#
#......................................#
#......................................#
#......................................#
#......................................#
#...........................===========#
#......................................#
#......................................#
#......................................#
#......................................#
#======================================#