#===========================================#
#...............<==>....<==>................#
#...........................................#
#...........................................#
#...........................................#
#=========>.......................<=========#
#==>.................==.................<===#
#................<==>..<==>.................#
#...........................................#
#...........................................#
#.....<====#....................#===>.......#
#..........#===.................#...........#
#..........#....................#...........#
#..........#...............<====#...........#
#..........#....................#...........#
#===>......#....................#.......<===#
#..........#....................#...........#
#..........#.....=====..........#...........#
#..........#....................#...........#
#..........#....................#...........#
#......<===#===>................#===>.......#
#..........#....................#...........#
#..........#................<===#...........#
#..........#....................#...........#
#..........#....................#...........#
#===>......#.......<===>........<===========#
#..........#................................#
#..........#................................#
#..........#................................#
#..........#................................#
#===========================================#