#___________________________________________#
#...........................................#
#...........................................#
#...........................................#
#.....................................<=====#
#.........................................A.#
#...........................................#
#...........................................#
#...........................................#
#==..............................<==>.......#
#...........................................#
#...........................................#
#...........................................#
#...........................................#
#...<========================>..............#
#...................m.......................#
#...........................................#
#...........................................#
#...........................................#
#...........................................#
#...........................................#
#...........................................#
#...........................................#
#...........................................#
#====>......................................#
#.Dp........................................#
#...........................................#
#...........................................#
#...........................................#
#...........................................#
#-----======================================#
#...........................................#
#...........................................#
#...........................................#
#...........................................#
#...........................................#