#___________________________________________#
#...........................................#
#...........................................#
#...........................................#
#.....................................<=====#
#.........................................d.#
#...........................................#
#...........................................#
#...........................................#
#................................<==>.......#
#...........................................#
#...........................................#
#...........................................#
#...........................................#
#...<========================>..............#
#...................m.......................#
#...........................................#
#...........................................#
#...........................................#
#...........................................#
#...........................................#
#...........................................#
#...........................................#
#...........................................#
#====>......................................#
#.dp........................................#
#...........................................#
#...........................................#
#...........................................#
#...........................................#
#-----======================================#
#...........................................#
#...........................................#
#...........................................#
#...........................................#
#...........................................#