#___________________________________________#
#...........................................#
#...........................................#
#...........................................#
#...............<=====>...............<=====#
#.........................................d.#
#...........................................#
#...........................................#
#...........................................#
#......<====>...........<=========>.........#
#...........................................#
#...........................................#
#...........................................#
#...........................................#
#=====>...............................<=====#
#...........................................#
#...........................................#
#...........................................#
#...........................................#
#...........<===================>...........#
#.......................p...................#
#...........................................#
#...........................................#
#...........................................#
#====>......................................#
#.d.........................................#
#...........................................#
#...........................................#
#...........................................#
#...........................................#
#===========================================#
#...........................................#
#...........................................#
#...........................................#
#...........................................#
#...........................................#