#___________________________________________#
}...........................................{
}....................................<===>..{
}.....................................pD....{
}...........................................{
}...........................................{
}...........................................{
}..........==......=......=......=..........{
}...........................................{
}.....=.....................................{
}...........................................{
}...........................................{
}...........................................{
}...........................................{
}..=........................................{
}...........................................{
}...........................................{
}...........................................{
}...........................................{
}.......=...................................{
}...........................................{
}...........................................{
}.............<======================>.<====#
}...............................l.........L.#
}...........................................#
}...........................................#
}...........................................#
}...........................................#
}...........................................#
}...........................................#
#===========================================#
#...........................................#
#...........................................#
#...........................................#
#...........................................#
#...........................................#